1111111111111111100000000000000000000001111100000000000000000000000000000000000000000000000000000000
0000000011111111111111111111111101111111111000000001111100011111111111111111111111111111111100000000
0000011111111111111111111111111100111111111100001111111111111111111111111111111111111111111111000000
0000111111111111111111110111111000110000000011101111111111111111111111111111111111111111111100000000
0000000000011111111111111111111100000000000011111111111111111111111111111111111111111111011100000000
0000000001111111111111111111101100000000000011111111111111111111111111111111111111111111110000000000
0000000001111111111111111100000000000000000011111111111111111111111111111111111111111110110000000000
0000000001111111111111100000000000000000000111111111111111111111111111111111111111110111110000000000
0000000000111111101111000000000000000000011111111111111111111111111111111111111111111000000000000000
0000000000011111111011110000000000000000011111111111111111111111110011111111111111111100000000000000
0000000000000111111100010000000000000000111111111111111111111111100000111100011111000110000000000000
0000000000000000001111111111000000000000011111111111111111111110000000011000001111001111000000000000
0000000000000000000011111111110000000000000111111111111111111100000000000000011110111111100000000000
0000000000000000000111111111111111100000000000000111111111110000000000000000000110111110111111111000
0000000000000000000011111111111111100000000000000011111111110000000000000000000011110011000111110000
0000000000000000000001111111111111000000000000000011111111110110000000000000000000001111101100000000
0000000000000000000000011111111111000000000000000011111111001110000000000000000001111111111110000000
0000000000000000000000001111111100000000000000000001111111001100000000000000000011111111111110000000
0000000000000000000000001111111000000000000000000000111100000000000000000000000011111111111110000000
0000000000000000000000001111100000000000000000000000000000000000000000000000000000000001111000000110
0000000000000000000000001111000000000000000000000000000000000000000000000000000000000000000001111000
0000000000000000000000000111000000000000000000000000000000000000000000000000000000000000000000000000
0000000000000000000000000001100000000000000000000000000000000000000000000000000000000000000000000000